NO assets/textures/bluestone.png
SO assets/textures/purplestone.png
WE assets/textures/wall_3.png
EA assets/textures/pillar.png
F 80,0,0
C 10,10,30

11111111
1000000011            1111
11100S00011           1001111111111
  11111101           11000000000001
       1001         110011111111001
       1001         1001       1001
        101111      1001       1001
        1000001111111001       1001          1111
        1000000000000001        1001         1001
        1111111111111111         1001        1001
                                  1001       1001
                                   10011111111001
                                   11000000000001
                                   11111111111101
                                              101111111
                                              1000000001
                                               1000000001
                                              100111110001
                                             1001    10001
                                            1001      10001
                                           1001        1001
                                          1001          1001
                                         10001          1001
                                        100001          1001
                                       1000001          1001
                                      10000001          1001
                                     100000001111111111111001
                                    1000000000000000000000001
                                    1000000000000000000000001
                                    1000000000000000000000001
                                    1000000000000000000000001
                                    1000000000000000000000001
                                    1000000000000000000000001
                                    1000000000000000000000001
                                    1000000000000000000000001
                                    1000000000000000000000001
                                    1000000000000000000000001
                                    1000000000000000000000001
                                    1000000000000000000000001
                                    1000000000000000000000001
                                    1000000000000000000000001
                                    1000000000000000000000001
                                    1000000000000000000000001
                                    1000000000000000000000001
                                    1000000000000000000000001
                                    1000000000000000000000001
                                    1000000000000000000000001
                                    1000000000000000000000001
                                    1000000000000000000000001
                                    1000000000000000000000001
                                    1000000000000000000000001
                                    1000000000000000000000001
                                    1000000000000000000000001
                                    1000000000000000000000001
                                    1000000000000000000000001
                                    1000000000000000000000001
                                    1000000000000000000000001
                                    1000000000000000000000001
                                    1000000000000000000000001
                                    1000000000000000000000001
                                    1000000000000000000000001
                                    1000000000000000000000001
                                    1000000000000000000000001
                                    1000000000000000000000001
                                    1000000000000000000000001
                                    1000000000000000000000001
                                    1000000000000000000000001
                                    1000000000000000000000001
                                    1000000000000000000000001
                                    1000000000000000000000001
                                    1000000000000000000000001
                                    1000000000000000000000001
                                    1000000000000000000000001
                                    1000000000000000000000001
                                    1111111111111111111111111